{
    "0": "#789262",  
    "1": "#555555",  
    "2": "#006400",  
    "3": "#00ff00",  
    "4": "#ff4500",  
    "5": "#8a2be2"   
}